%%%%%%%
%. Po.%
%  %% %
%  %o %
%%   .%
%o %%%%
%%%%%%%
